11111111111111111111111111111
10000000000001000000000000001
10P0000C000001000E00000000001
11111111110001001110001111101
1000000C000001000000000X00001
10000000000001XX0XX1100XXXXX1
100000000X0001000XXX100011001
10000000000001000000000000001
10001111111111111111101000001
100000000X00000000C1001000001
1000010000000100XXX10X10000C1
10000100000001000000001000001
1000010CC000010000XXXX0000001
1C000000000X0100000000000C001
11111111111111111111111111111