11111111111111111111111111111
10000000000001000000000000001
1000000C0000010000X0000000E01
100000000000010000C0000000001
1000000C000001000000000X00001
10000000000001000000000000001
100000000XXXXXXXXXXX000000001
1000000000XXXXXXXXX0000000001
1000000000XXXXXXXXX0001000001
100000000X00000000C0001000001
1000P0000000000000000010000C1
10000000000001000000001000001
11111111111111111111111111111