111111111111111111111111111111
10C00C00C0C0000000000100000001
10CX0C00C0C0000000000100000001
10C00C00CXC0000000000100000001
10C00C00C0C0000000000000000001
10CX0C00C0C0000000000100000001
100000000000000000000100000001
1EP00000000000C000000100000001
100000000000000000000100000001
10C0XC00C0C0000000000111111111
10C00C00C0C0000000000100000001
10C00C00C0C0000000000100000001
10C0XC00C0C0000000000000000001
10C00C00C0C0000000000100000001
10C00C00C0C0000000000100000001
111111111111111111111111111111