111111111111111111111111111111
1000X0X00000C00111000100000X01
10C00C00CX0XC00CCC00010X000001
10CX0C00C000CX0C0C000100011001
10C00C00C000C00C0C000100X11001
10CX0C0XC000C0XC0C000100011001
10000000000000000000X1X0000001
1EP0000000000000X0000000000X01
10000000000000000000X100000001
10CX0C00CX0XC00000000111111111
10C00C00C000C0XC0C000100111111
10C00C0XC000C00C0C000100000001
10CX0C00C000CX0C0C000000000001
10C00C00CX0XC00CCC000100000001
1000X0X00000C00111000100111101
111111111111111111111111111111