11111111111111
100PC000C0X0E1
1000000XC0X0X1
11111111111111
