11111111111111111111111111111
10000000000000000000000000001
10PCCCCC000001000E00000000001
100CCCCC000000000000000000001
1000000C000001000000000X00001
10000000000001XX0XX1100XXXXX1
100000000X0001000XXX100011001
10000000000000000000000000001
10001111111000011111101000001
100000000X0000000001001000001
1000010000000100XXX10X1000001
10000100000001000000001000001
100001000000010000XXXX0000001
10000000000X01000000000000001
11111111111111111111111111111