11111111111111111111111111111
10000000000001000000000000001
1000000C0000010000X0000000E01
100000000000010000C0000000001
1000000C000001000000000X00001
10000000000001XXXXX0000XXXXX1
100000000X0000000XXX000000001
10000000000000000000000000001
10000000000000000000001000001
100000000X00000000C0001000001
1000P0000000010000000010000C1
10000000000001000000001000001
1000000CC000010000XXXX0000001
10000000000001000000000000001
11111111111111111111111111111