11111111111111
100000000X0001
100PCE0XC0X0X1
1000000C000001
11111111111111
