11111111111111
10000000000001
10000000000001
100000000X0X01
10000000000001
10000000000001
100PCE00000001
10000000000001
10000000000001
10000000X0X0X1
10000000000001
10000000000001
11111111111111