11111111111111
10000000000001
100PCE00000001
10000000000001
11111111111111