1111111111111
1000001000EC1
10000000X0C01
1P000C0000001
1111111111111