1111111111111
10000010000X1
1000000000001
1P000CCC000E1
1111111111111